10
+-+-+-+-+-+-+-+-+-+-+
|               |   |
+ +-+   +-+ +-+ +-+ +
|             |     |
+   +-+ + +   + +   +
|  A| | | |T  | |   |
+-+ + + + +   +-+-+ +
| |    P        | | |
+ +   +-+ +     + + +
|       | |         |
+-+     + + +-+-+   +
|       |           |
+       +   +     +-+
|       |   |       |
+ +-+ +-+ +-+-+-+   +
|     | |     |     |
+-+   + + +-+ +   + +
|       |V|       |H|
+-+-+   + + +     + +
|           |       |
+-+-+-+-+-+-+-+-+-+-+
