10
+-+-+-+-+-+-+-+-+-+-+
| |   |  A          |
+-+   + +-+-+ +-+ +-+
| |             |   |
+ +-+   +-+-+ + +-+ +
|       |T  | |     |
+-+ +-+-+ + +-+-+-+ +
|     |   | |       |
+   + + +-+ +     + +
|   |             | |
+   +     +-+ +-+ +-+
|   |         |     |
+ +-+   + +-+ +   +-+
|   |  H| |         |
+   +   + +       + +
|        V        | |
+-+   +-+   +-+   + +
| |          P      |
+ +-+ +-+   + + + + +
|   |   |   | | | | |
+-+-+-+-+-+-+-+-+-+-+
