10
+-+-+-+-+-+-+-+-+-+-+
|A            |   | |
+ + +-+-+-+-+ +   + +
| |               | |
+ + +-+     +-+   + +
|     |           | |
+     +           + +
|                   |
+         +-+-+ +-+ +
|         |   |     |
+         + + +   + +
|          V|     | |
+-+-+       + +-+ + +
| |  T          |   |
+ + +-+ +   +   +   +
|       |   |       |
+   +-+-+-+-+ + +-+-+
|             |H P  |
+ +-+-+       + +-+ +
|             |   | |
+-+-+-+-+-+-+-+-+-+-+
