10
+-+-+-+-+-+-+-+-+-+-+
| | |               |
+-+ + +-+ +-+   +   +
| | |      A    |   |
+-+ +         + + +-+
|             |     |
+ +-+         +   +-+
|   |          V  | |
+-+ +-+   +-+-+ + +-+
| |             |   |
+ +-+   +-+     + +-+
|         |         |
+     +-+ + +-+ +-+-+
|H    |T          | |
+     +-+-+-+     + +
|     |             |
+     + +     + +-+ +
|       |     |     |
+ +-+   + +-+ +   +-+
|             |P    |
+-+-+-+-+-+-+-+-+-+-+
