10
+-+-+-+-+-+-+-+-+-+-+
|A                  |
+ +-+-+-+-+-+-+-+-+ +
| |       |H      | |
+ +       +       + +
| |      V        | |
+ +   +-+-+-+-+-+-+ +
| |               | |
+ +-+-+-+-+-+-+-+-+ +
|                   |
+                   +
|          P        |
+                   +
|                   |
+                   +
|                   |
+                   +
|                   |
+ +-+-+         +-+ +
|    V|         |T  |
+-+-+-+-+-+-+-+-+-+-+
