8
+-+-+-+-+-+-+-+-+
|               |
+-+-+     +-+ +-+
|               |
+       +-+-+-+ +
|         | |   |
+ + +-+ +-+ + +-+
| | |V|  H  |   |
+ + + + +   +   +
|       |       |
+   + +-+-+   + +
|   |  P      | |
+   +   +     + +
|       |T      |
+ + +-+ + +     +
| |     | |A    |
+-+-+-+-+-+-+-+-+
