8
+-+-+-+-+-+-+-+-+
|   |  A|       |
+ +-+   +-+ +   +
| |         |   |
+ + +       + + +
|   |       | | |
+ +-+     +-+ + +
|  V        |   |
+ +-+-+-+   +-+ +
|      P    |   |
+ +-+     +-+ + +
|            H| |
+ +-+-+       + +
|  T  |         |
+     +-+     + +
|             | |
+-+-+-+-+-+-+-+-+
